19	PAUL HARDCASTLE
2 Become 1	SPICE GIRLS
21 Seconds	SO SOLID CREW
3 Am Eternal	KLF FEATURING THE CHILDREN OF THE REVOLUTION
4 Minutes	MADONNA FEAT. JUSTIN TIMBERLAKE
7 Days	CRAIG DAVID
7 Years	LUKAS GRAHAM
99 Red Balloons	NENA
9pm Till I Come	ATB
A Bridge Over You	THE LEWISHAM & GREENWICH NHS CHOIR
A Different Beat	BOYZONE
A Different Corner	GEORGE MICHAEL
A Good Heart	FEARGAL SHARKEY
A Groovy Kind Of Love	PHIL COLLINS
A Hard Day's Night	BEATLES
A Little Bit More	911
A Little Less Conversation	ELVIS VS JXL
A Little Peace	NICOLE
A Little Time	BEAUTIFUL SOUTH
A Moment Like This	LEONA LEWIS
A Town Called Malice	JAM
A Whiter Shade Of Pale	PROCOL HARUM
A World Without Love	PETER & GORDON
Abba-esque Ep	ERASURE
About You Now	SUGABABES
Against All Odds	MARIAH CAREY FEATURING WESTLIFE
Against All Odds	STEVE BROOKSTEIN
Ain't No Doubt	JIMMY NAIL
Ain't Nobody	LL COOL J
Airplanes	BOB FT HAYLEY WILLIAMS
Albatross	FLEETWOOD MAC
All About That Bass	MEGHAN TRAINOR
All About Tonight	PIXIE LOTT
All About You	MCFLY
All Around The World	LISA STANSFIELD
All Around The World	OASIS
All Kinds Of Everything	DANA
All Or Nothing	SMALL FACES
All Summer Long	KID ROCK
All That I Need	BOYZONE
All That She Wants	ACE OF BASE
All The Things She Said	T.A.T.u.
All This Time	MICHELLE
All Time Low	WANTED
All You Need Is Love	BEATLES
Always On My Mind	PET SHOP BOYS
Always Yours	GARY GLITTER
Am I Wrong	NICO & VINZ
Amazing Grace	THE PIPES & DRUMS & MILITARY BAND OF THE ROYAL SCOTS DRAGOON GUARDS
America	RAZORLIGHT
American Boy	ESTELLE FEAT. KANYE WEST
American Pie	MADONNA
Angel	SHAGGY FEATURING RAYVON
Angel Fingers	WIZZARD
Angelo	BROTHERHOOD OF MAN
Animals	MARTIN GARRIX
Annie's Song	JOHN DENVER
Another Brick In The Wall Part 2	PINK FLOYD
Another Chance	ROGER SANCHEZ
Any Dream Will Do	JASON DONOVAN
Anyone Of Us Stupid Mistake	GARETH GATES
Anyone Who Had A Heart	CILLA BLACK
Anything Is Possible/ Evergreen	WILL YOUNG
Apache	SHADOWS
Are 'Friends' Electric?	TUBEWAY ARMY
Are You Lonesome Tonight	ELVIS PRESLEY WITH THE JORDANAIRES
Are You Ready For Love	ELTON JOHN
Are You With Me	LOST FREQUENCIES
Ashes To Ashes	DAVID BOWIE
Atomic	BLONDIE
Axel F	CRAZY FROG
Babe	TAKE THAT
Baby Come Back	EQUALS
Baby Come Back	PATO BANTON
Baby Jane	ROD STEWART
Baby Jump	MUNGO JERRY
Baby Love	SUPREMES
Baby Now That I've Found You	FOUNDATIONS
Baby One More Time	BRITNEY SPEARS
Baby's Coming Back	McFLY
Babycakes	3 OF A KIND
Back For Good	TAKE THAT
Back Home	ENGLAND WORLD CUP SQUAD
Back To Life However Do You Want Me	SOUL II SOUL FEATURING CARON WHEELER
Bad Boys	ALEXANDRA BURKE FEAT. FLO RIDA
Bad Moon Rising	CREEDENCE CLEARWATER REVIVAL
Bad Romance	LADY GAGA
Bad To Me	BILLY J. KRAMER & THE DAKOTAS
Bag It Up	GERI HALLIWELL
Band Of Gold	FREDA PAYNE
Bang Bang	JESSIE J
Barbados	TYPICALLY TROPICAL
Barbie Girl	AQUA
Be Faithful	FATMAN SCOOP FEAT. THE CROOKLYN CLAN
Beat Again	JLS
Beat Surrender	JAM
Beautiful	CHRISTINA AGUILERA
Beautiful Day	U2
Beautiful Girls	SEAN KINGSTON
Beautiful Liar	BEYONCE & SHAKIRA
Beautiful Monster	NEYO
Because I Got High	AFROMAN
Because We Want To	BILLIE
Beetlebum	BLUR
Begin The Beguine	JULIO IGLESIAS
Being With You	SMOKEY ROBINSON
Belfast Child	SIMPLE MINDS
Believe	CHER
Beneath Your Beautiful	LABRINTH FT EMELI SANDE
Billie Jean	MICHAEL JACKSON
Billy, Don't Be A Hero	PAPER LACE
Black Coffee	ALL SAINTS
Black Magic	LITTLE MIX
Black Or White	MICHAEL JACKSON
Blackberry Way	MOVE
Blame	CALVIN HARRIS FT JOHN NEWMAN
Blame It On The Weatherman	B*WITCHED
Bleeding Love	LEONA LEWIS
Block Rockin' Beats	CHEMICAL BROTHERS
Blockbuster	SWEET
Blood On The Dance Floor	MICHAEL JACKSON
Blue Da Ba Dee	EIFFEL 65
Blue Moon	MARCELS
Blurred Lines	ROBIN THICKE
Bohemian Rhapsody	QUEEN
Bom Bom	SAM & THE WOMP
Bonkers	DIZZEE RASCAL FEAT. ARMAND VAN HELDEN
Boom Boom Boom	OUTHERE BROTHERS
Boom Boom Boom Boom!!	VENGABOYS
Boom Boom Pow	BLACK EYED PEAS
Boom! Shake The Room	JAZZY JEFF & THE FRESH PRINCE
Boombastic	SHAGGY
Bootie Call	ALL SAINTS
Born To Make You Happy	BRITNEY SPEARS
Bound 4 Da Reload Casualty	OXIDE & NEUTRINO
Boys And Girls	PIXIE LOTT
Brass In Pocket	PRETENDERS
Break Your Heart	TAIO CRUZ
Breakfast At Tiffany's	DEEP BLUE SOMETHING
Breathe	BLU CANTRELL FEAT. SEAN PAUL
Breathe	PRODIGY
Breathless	CORRS
Bridge Over Troubled Water	ARTISTS FOR GLENFELL
Bridge Over Troubled Water	SIMON & GARFUNKEL
Bright Eyes	ART GARFUNKEL
Brimful Of Asha	CORNERSHOP
Bring It All Back	S CLUB 7
Bring Me To Life	EVANESCENCE
Bring Your Daughter To The Slaughter	IRON MAIDEN
Bulletproof	LA ROUX
Burn	ELLIE GOULDING
Burn	USHER
Bye Bye Baby	BAY CITY ROLLERS
C'est La Vie	B*WITCHED
California Gurls	KATY PERRY FT SNOOP DOGG
Call Me	BLONDIE
Call Me Maybe	CARLY RAE JEPSEN
Call My Name	CHERYL
Call On Me	ERIC PRYDZ
Can The Can	SUZI QUATRO
Can We Fix It	BOB THE BUILDER
Can't Buy Me Love	BEATLES
Can't Fight The Moonlight	LEANN RIMES
Can't Get You Out Of My Head	KYLIE MINOGUE
Can't Give You Anything But My Love	STYLISTICS
Candy	ROBBIE WILLIAMS
Candy Girl	NEW EDITION
Cannonball	LITTLE MIX
Caravan Of Love	HOUSEMARTINS
Careless Whisper	GEORGE MICHAEL
Cars	GARY NUMAN
Cathy's Clown	EVERLY BROTHERS
Cha Cha Slide	DJ CASPER
Chain Reaction	DIANA ROSS
Changed The Way You Kiss Me	EXAMPLE
Changes	OZZY & KELLY OSBOURNE
Changing	SIGMA FT PALOMA FAITH
Chanson D'amour	MANHATTAN TRANSFER
Cheerleader	OMI
China In Your Hand	T'PAU
Chirpy Chirpy Cheep Cheep	MIDDLE OF THE ROAD
Chocolate Salty Balls	CHEF
Cinderella Rockefella	ESTHER & ABI OFARIM
Clair	GILBERT O'SULLIVAN
Closer	NE-YO
Closer	THE CHAINSMOKERS FT HALSEY
Club Can't Handle Me	FLO RIDA FT DAVID GUETTA
Cold Water	MAJOR LAZER FT JUSTIN BIEBER & MØ
Colourblind	DARIUS
Combine Harvester Brand New Key	WURZELS
Come On Eileen	DEXY'S MIDNIGHT RUNNERS WITH THE EMERALD EXPRESS
Come On You Reds	MANCHESTER UNITED FOOTBALL CLUB
Come Outside	MIKE SARNE WITH WENDY RICHARD
Concrete And Clay	UNIT FOUR PLUS TWO
Confessin' That I Love You	FRANK IFIELD
Congratulations	CLIFF RICHARD
Cotton Eye Joe	REDNEX
Counting Stars	ONEREPUBLIC
Country House	BLUR
Coward Of The County	KENNY ROGERS
Coz I Luv You	SLADE
Crashed The Wedding	BUSTED
Crazy	GNARLS BARKLEY
Crazy In Love	BEYONCE
Crazy Stupid Love	CHERYL COLE FT TINIE TEMPAH
Crossroads	BLAZIN' SQUAD
Crying	DON MCLEAN
Crying In The Chapel	ELVIS PRESLEY
Cum On Feel The Noize	SLADE
D I V O R C E	BILLY CONNOLLY
D'you Know What I Mean?	OASIS
Da Ya Think I'm Sexy	ROD STEWART
Dakota	STEREOPHONICS
Dance On!	SHADOWS
Dance With Me Tonight	OLLY MURS
Dance Wiv Me	DIZZEE RASCAL FEAT. CALVIN HARRIS & CHROME
Dancing In The Streets	DAVID BOWIE & MICK JAGGER
Dancing Queen	ABBA
Dare	GORILLAZ
Day & Night	BILLIE PIPER
Day Tripper	BEATLES
Daydreamer	DAVID CASSIDY
December '63 Oh What A Night	FOUR SEASONS
Deeper Underground	JAMIROQUAI
Deeply Dippy	RIGHT SAID FRED
Desire	U2
Despacito	LUIS FONSI & DADDY YANKEE FT JUSTIN BIEBER
Devil Gate Drive	SUZI QUATRO
Diamonds	JET HARRIS & TONY MEEHAN
Diamonds	RIHANNA
Diane	BACHELORS
Dilemma	NELLY FEATURING KELLY ROWLAND
Dirrty	CHRISTINA AGUILERA FEAT. REDMAN
Dirtee Disco	DIZZEE RASCAL
Discotheque	U2
Distant Drums	JIM REEVES
Dizzy	TOMMY ROE
Dizzy	VIC REEVES & THE WONDER STUFF
Do It Again	BEACH BOYS
Do The Bartman	SIMPSONS
Do They Know It's Christmas	BAND AID 30
Do They Know It's Christmas?	BAND AID
Do They Know It's Christmas?	BAND AID 20
Do They Know It's Christmas?	BAND AID II
Do Wah Diddy Diddy	MANFRED MANN
Do You Love Me	BRIAN POOLE & THE TREMELOES
Do You Mind	ANTHONY NEWLEY
Do You Really Like It	DJ PIED PIPER & THE MASTERS OF CEREMONIES
Do You Really Want To Hurt Me	CULTURE CLUB
Doctor Jones	AQUA
Doctorin' The Tardis	TIMELORDS
Domino	JESSIE J
Don't Be So Hard On Yourself	JESS GLYNNE
Don't Call Me Baby	MADISON AVENUE
Don't Cha	PUSSYCAT DOLLS FEAT. BUSTA RHYMES
Don't Cry For Me Argentina	JULIE COVINGTON
Don't Give Up	CHICANE FEATURING BRYAN ADAMS
Don't Give Up On Us	DAVID SOUL
Don't Go	WRETCH 32 FT JOSH KUMRA
Don't Go Breaking My Heart	ELTON JOHN & KIKI DEE
Don't Hold Your Breath	NICOLE SCHERZINGER
Don't Leave Me This Way	COMMUNARDS WITH SARAH-JANE MORRIS
Don't Let The Sun Go Down On Me	GEORGE MICHAEL & ELTON JOHN
Don't Look Back In Anger	OASIS
Don't Speak	NO DOUBT
Don't Stand So Close To Me	POLICE
Don't Stop Me Now	McFLY
Don't Stop Movin'	S CLUB 7
Don't Stop Wiggle Wiggle	OUTHERE BROTHERS
Don't Throw Your Love Away	SEARCHERS
Don't Turn Around	ASWAD
Don't Wanna Go Home	JASON DERULO
Don't You Want Me	HUMAN LEAGUE
Don't You Worry Child	SWEDISH HOUSE MAFIA
Doop	DOOP
Double Barrel	DAVE & ANSIL COLLINS
Down Down	STATUS QUO
Down Under	MEN AT WORK
Drag Me Down	ONE DIRECTION
Dreadlock Holiday	10 C.C.
Dreamer	LIVIN' JOY
Dreams	GABRIELLE
Dry Your Eyes	STREETS
Dub Be Good To Me	BEATS INTERNATIONAL FEATURING LINDY LAYTON
Dynamite	TAIO CRUZ
Déjà Vu	BEYONCE FEAT. JAY-Z
Earth Song	MICHAEL JACKSON
Easy Love	SIGALA
Easy Lover	PHILIP BAILEY (DUET WITH PHIL COLLINS)
Ebeneezer Goode	SHAMEN
Ebony And Ivory	PAUL McCARTNEY & STEVIE WONDER
End Of The Road	BOYZ II MEN
Ernie The Fastest Milkman In The West	BENNY HILL
Especially For You	KYLIE MINOGUE & JASON DONOVAN
Eternal Flame	ATOMIC KITTEN
Eternal Flame	BANGLES
Eternity	ROBBIE WILLIAMS
Evacuate The Dancefloor	CASCADA
Everlasting Love	LOVE AFFAIR
Every Breath You Take	POLICE
Every Little Thing She Does Is Magic	POLICE
Every Loser Wins	NICK BERRY
Everybody Hurts	HELPING HAITI
Everybody In Love	JLS
Everybody's Free To Wear Sunscreen	BAZ LUHRMANN
Everything Changes	TAKE THAT
Everything I Do I Do It For You	BRYAN ADAMS
Everything I Own	BOY GEORGE
Everything I Own	KEN BOOTHE
Everytime	BRITNEY SPEARS
Eye Level	SIMON PARK ORCHESTRA
Eye Of The Tiger	SURVIVOR
F U R B F U Right Back	FRANKEE
Fairground	SIMPLY RED
Fame	IRENE CARA
Fastlove	GEORGE MICHAEL
Feel It	TAMPERER FEATURING MAYA
Feel The Love	RUDIMENTAL FT JOHN NEWMAN
Feels Like I'm In Love	KELLY MARIE
Fernando	ABBA
Ferry 'cross The Mersey	CHRISTIANS, HOLLY JOHNSON, PAUL McCARTNEY, GERRY MARSDEN & STOCK AITKEN WATERMAN
Figaro	BROTHERHOOD OF MAN
Fight For This Love	CHERYL COLE
Fight Song	RACHEL PLATTEN
Fill Me In	CRAIG DAVID
Fire	CRAZY WORLD OF ARTHUR BROWN
Fireflies	OWL CITY
Firestarter	PRODIGY
First Cut Is The Deepest	ROD STEWART
Five Colours In Her Hair	McFLY
Five Live Ep	GEORGE MICHAEL & QUEEN WITH LISA STANSFIELD
Flat Beat	MR OIZO
Flava	PETER ANDRE
Float On	FLOATERS
Fly Away	LENNY KRAVITZ
Flying Without Wings	WESTLIFE
Fool Again	WESTLIFE
Foot Tapper	SHADOWS
Forever And Ever	SLIK
Forever Love	GARY BARLOW
Forget You	CEE LO GREEN
Frankie	SISTER SLEDGE
Freak Like Me	SUGABABES
Freak Me	ANOTHER LEVEL
Free	DENIECE WILLIAMS
Freedom	WHAM!
From Me To You	BEATLES
Frozen	MADONNA
Fuck It I Don't Want You Back	EAMON
Gangnam Style	PSY
Gangsta's Paradise	COOLIO FEATURING LV
Gecko Overdrive	OLIVER HELDENS & BECKY HILL
Genie In A Bottle	CHRISTINA AGUILERA
Geno	DEXY'S MIDNIGHT RUNNERS
Get Away	GEORGIE FAME & THE BLUE FLAMES
Get Back	BEATLES WITH BILLY PRESTON
Get Down	GILBERT O'SULLIVAN
Get It On	T REX
Get Lucky	DAFT PUNK FT PHARRELL WILLIAMS
Get Off Of My Cloud	ROLLING STONES
Get Right	JENNIFER LOPEZ
Get Up Rattle	BINGO PLAYERS FT FAR EAST
Gettin' Over You	DAVID GUETTA FT CHRIS WILLIS
Ghetto Gospel	2PAC FEAT. ELTON JOHN
Ghost	ELLA HENDERSON
Ghost Town	SPECIALS
Girlfriend	BILLIE
Give A Little Love	BAY CITY ROLLERS
Give It To Me	TIMBALAND FEAT. NELLY FURTADO & JUSTIN TIMBERLAKE
Give It Up	K C & THE SUNSHINE BAND
Give Me Everything	PITBULL
Glad All Over	DAVE CLARK FIVE
Glad You Came	WANTED
Go Let It Out	OASIS
Go Now	MOODY BLUES
Going Underground	JAM
Gonna Make You A Star	DAVID ESSEX
Good Feeling	FLO RIDA
Good Luck Charm	ELVIS PRESLEY
Good Times	ROLL DEEP
Good Timin'	JIMMY JONES
Good Vibrations	BEACH BOYS
Goodbye	SPICE GIRLS
Goodies	CIARA FEAT. PETEY PABLO
Goodnight Girl	WET WET WET
Goody Two Shoes	ADAM ANT
Gotta Get Thru This	DANIEL BEDINGFIELD
Grace Kelly	MIKA
Grandad	CLIVE DUNN
Greatest Day	TAKE THAT
Green Door	SHAKIN' STEVENS
Green Green Grass Of Home	TOM JONES
Green Light	ROLL DEEP
Grenade	BRUNO MARS
Groovejet If This Ain't Love	SPILLER
Gym And Tonic	SPACEDUST
Hall Of Fame	SCRIPT FT WILL I AM
Hallelujah	ALEXANDRA BURKE
Hand On Your Heart	KYLIE MINOGUE
Hangin' Tough	NEW KIDS ON THE BLOCK
Happy	PHARRELL WILLIAMS
Happy Talk	CAPTAIN SENSIBLE
Have I The Right	HONEYCOMBS
Have You Ever	S CLUB 7
He Ain't Heavy He's My Brother	JUSTICE COLLECTIVE
He Ain't Heavy, He's My Brother	HOLLIES
Heart	PET SHOP BOYS
Heart Of Glass	BLONDIE
Heart Skips A Beat	OLLY MURS FT RIZZLE KICKS
Heartbeat	STEPS
Heatwave	WILEY FT MS D
Heaven	DJ SAMMY & YANOU FEATURING DO
Heaven Is A Place On Earth	BELINDA CARLISLE
Hello	ADELE
Hello	LIONEL RICHIE
Hello Goodbye	BEATLES
Help!	BEATLES
Hero	ENRIQUE IGLESIAS
Hero	X FACTOR FINALISTS
Heroes	X FACTOR FINALISTS 2010
Hey Baby	DJ OTZI
Hey Girl Don't Bother Me	TAMS
Hey Jude	BEATLES
Hideaway	KIESZA
Hips Don't Lie	SHAKIRA FEAT. WYCLEF JEAN
Hit Me With Your Rhythm Stick	IAN DURY & THE BLOCKHEADS
Hold Me Close	DAVID ESSEX
Hold My Hand	JESS GLYNNE
Hole In The Head	SUGABABES
Holiday	DIZZEE RASCAL FEAT. CHROME
Holler	SPICE GIRLS
Honky Tonk Women	ROLLING STONES
Hot Love	T REX
Hot Right Now	DJ FRESH FT RITA ORA
House Every Weekend	DAVID ZOWIE
House Of Fun	MADNESS
How Can I Be Sure	DAVID CASSIDY
How Deep Is Your Love	TAKE THAT
How Do You Do It?	GERRY & THE PACEMAKERS
How We Do Party	RITA ORA
Hung Up	MADONNA
I Believe	ROBSON GREEN & JEROME FLYNN
I Believe I Can Fly	R KELLY
I Bet You Look Good On The Dancefloor	ARCTIC MONKEYS
I Can't Get No Satisfaction	ROLLING STONES
I Can't Help Falling In Love With You	UB40
I Can't Stop Loving You	RAY CHARLES
I Could Be The One	AVICII VS NICKY ROMERO
I Don't Care	CHERYL
I Don't Feel Like Dancin'	SCISSOR SISTERS
I Don't Like Mondays	BOOMTOWN RATS
I Don't Wanna Dance	EDDY GRANT
I Don't Wanna Know	MARIO WINANS FEAT. ENYA & P.DIDDY
I Don't Want To Talk About It	ROD STEWART
I Feel Fine	BEATLES
I Feel For You	CHAKA KHAN
I Feel Love	DONNA SUMMER
I Feel You	PETER ANDRE
I Got U	DUKE DUMONT FT JAX JONES
I Got You Babe	SONNY & CHER
I Got You Babe	UB40 FEATURING CHRISSIE HYNDE
I Gotta Feeling	BLACK EYED PEAS
I Have A Dream	WESTLIFE
I Hear You Knocking	DAVE EDMUNDS
I Heard It Through The Grapevine	MARVIN GAYE
I Just Called To Say I Love You	STEVIE WONDER
I Just Can't Stop Loving You	MICHAEL JACKSON
I Kissed A Girl	KATY PERRY
I Knew You Were Waiting For Me	ARETHA FRANKLIN & GEORGE MICHAEL
I Know Him So Well	ELAINE PAIGE & BARBARA DICKSON
I Like It	GERRY & THE PACEMAKERS
I Love It	ICONA POP FT CHARLI XCX
I Love To Love But My Baby Loves To Dance	TINA CHARLES
I Love You	CLIFF RICHARD & THE SHADOWS
I Love You Love Me Love	GARY GLITTER
I Only Have Eyes For You	ART GARFUNKEL
I Owe You Nothing	BROS
I Pretend	DES O'CONNOR
I Remember You	FRANK IFIELD
I Should Be So Lucky	KYLIE MINOGUE
I Should Have Known Better	JIM DIAMOND
I Think We're Alone Now	TIFFANY
I Took A Pill In Ibiza	MIKE POSNER
I Turn To You	MELANIE C
I Wanna Be The One	ETERNAL FEATURING BEBE WINANS
I Wanna Dance With Somebody Who Loves Me	WHITNEY HOUSTON
I Wanna Feel	SECONDCITY
I Wanna Sex You Up	COLOR ME BADD
I Want It That Way	BACKSTREET BOYS
I Want To Hold Your Hand	BEATLES
I Want To Know What Love Is	FOREIGNER
I Want To Wake Up With You	BORIS GARDINER
I Want You Back	MELANIE B FEATURING MISSY 'MISDEMEANOR' ELLIOTT
I Will Always Love You	WHITNEY HOUSTON
I Will Never Let You Down	RITA ORA
I Will Survive	GLORIA GAYNOR
I Wish I Was A Punk Rocker With Flowers In My Hair	SANDI THOM
I'd Do Anything For Love But I Won't Do That	MEAT LOAF
I'd Like To Teach The World To Sing In Perfect Harmony	NEW SEEKERS
I'll Be Missing You	PUFF DADDY & FAITH EVANS FEATURING 112
I'll Be Ok	McFLY
I'll Never Fall In Love Again	BOBBY GENTRY
I'll Never Find Another You	SEEKERS
I'll Stand By You	GIRLS ALOUD
I'm A Believer	MONKEES
I'm Alive	HOLLIES
I'm Gonna Be 500 Miles	THE PROCLAIMERS FEAT. BRIAN POTTER & ANDY PIPKIN
I'm Into Something Good	HERMAN'S HERMITS
I'm Not Alone	CALVIN HARRIS
I'm Not In Love	10 C.C.
I'm Still Waiting	DIANA ROSS
I'm The Leader Of The Gang I Am	GARY GLITTER
I'm The One	DJ KHALED FT JUSTIN BIEBER, QUAVO, CHANCE THE RAPPER & LIL WAYNE
I'm Your Man	WHAM!
I've Gotta Get A Message To You	BEE GEES
I've Never Been To Me	CHARLENE
Ice Ice Baby	VANILLA ICE
If	TELLY SAVALAS
If I Let You Go	WESTLIFE
If I Was	MIDGE URE
If I Were A Boy	BEYONCE
If Paradise Is Half As Nice	AMEN CORNER
If Tomorrow Never Comes	RONAN KEATING
If You Come Back	BLUE
If You Leave Me Now	CHICAGO
If You Tolerate This Your Children Will Be Next	MANIC STREET PREACHERS
If You're Not The One	DANIEL BEDINGFIELD
Ignition	R KELLY
Imagine	JOHN LENNON
Impossible	JAMES ARTHUR
In My Head	JASON DERULO
In The Summertime	MUNGO JERRY
In The Year 2525 Exorium And Terminus	ZAGER & EVANS
Independent Women Part 1	DESTINY'S CHILD
Innuendo	QUEEN
Inside	STILTSKIN
Into The Groove	MADONNA
Is There Something I Should Know	DURAN DURAN
Is This The Way To Amarillo?	TONY CHRISTIE FEAT. PETER KAY
Islands In The Stream	VANESSA JENKINS & BRYN WEST FEAT. TOM JONES & ROBIN GIBB
Israelites	DESMOND DEKKER & THE ACES
It Feels So Good	SONIQUE
It Wasn't Me	SHAGGY
It's A Sin	PET SHOP BOYS
It's All Over Now	ROLLING STONES
It's Chico Time	CHICO
It's Like That	RUN DMC VERSUS JASON NEVINS
It's My Birthday	WILL I AM FT CODY WISE
It's My Party	DAVE STEWART WITH BARBARA GASKIN
It's Not Unusual	TOM JONES
It's Now Or Never	ELVIS PRESLEY WITH THE JORDANAIRES
It's Over	ROY ORBISON
It's Raining Men	GERI HALLIWELL
Itsy Bitsy Teeny Weeny Yellow Polka Dot Bikini	BOMBALURINA FEATURING TIMMY MALLETT
Jack Your Body	STEVE 'SILK' HURLEY
Jailhouse Rock	ELVIS PRESLEY
January	PILOT
Japanese Boy	ANEKA
Jcb Song	NIZLOPI
Je T'aime Moi Non Plus	JANE BIRKIN & SERGE GAINSBOURG
Jealous Guy	ROXY MUSIC
Jealous Mind	ALVIN STARDUST
Jesus To A Child	GEORGE MICHAEL
Johnny Remember Me	JOHN LEYTON
Juliet	FOUR PENNIES
Jumpin' Jack Flash	ROLLING STONES
Just A Little	LIBERTY X
Just Dance	LADY GAGA
Just Like A Pill	PINK
Just Like Starting Over	JOHN LENNON
Just Lose It	EMINEM
Just The Way You Are Amazing	BRUNO MARS
Karma Chameleon	CULTURE CLUB
Keep On Movin'	FIVE
Keep On Running	SPENCER DAVIS GROUP
Killer	ADAMSKI
Killing In The Name	RAGE AGAINST THE MACHINE
Killing Me Softly	FUGEES
King	YEARS & YEARS
King Of My Castle	WAMDUE PROJECT
King Of The Road	ROGER MILLER
Kiss Kiss	HOLLY VALANCE
Knock Three Times	DAWN
Knockin' On Heaven's Door	DUNBLANE
Knowing Me Knowing You	ABBA
Kon-tiki	SHADOWS
Kung Fu Fighting	CARL DOUGLAS
La Bamba	LOS LOBOS
La Isla Bonita	MADONNA
La La La	NAUGHTY BOY FT SAM SMITH
Lady Hear Me Tonight	MODJO
Lady Madonna	BEATLES
Lady Marmalade	CHRISTINA AGUILERA
Lay Me Down	SAM SMITH FT JOHN LEGEND
Leave Right Now	WILL YOUNG
Let It Be	FERRY AID
Let Love Lead The Way	SPICE GIRLS
Let Me Be Your Fantasy	BABY D
Let Me Love You Until You Learn To Love	NE-YO
Let The Heartaches Begin	LONG JOHN BALDRY
Let's Dance	DAVID BOWIE
Let's Dance	FIVE
Let's Get Ready To Rhumble	PJ & DUNCAN
Let's Party	JIVE BUNNY & THE MASTERMIXERS
Life Is A Rollercoaster	RONAN KEATING
Lift Me Up	GERI HALLIWELL
Light My Fire	WILL YOUNG
Like A Prayer	MADONNA
Like Toy Soldiers	EMINEM
Lily The Pink	SCAFFOLD
Little Children	BILLY J. KRAMER & THE DAKOTAS
Little Red Rooster	ROLLING STONES
Little Sister	ELVIS PRESLEY
Little Things	ONE DIRECTION
Livin' La Vida Loca	RICKY MARTIN
Living Doll	CLIFF RICHARD & THE YOUNG ONES FEATURING HANK B MARVIN
Living On My Own	FREDDIE MERCURY
Loca People	SAK NOEL
Lola's Theme	SHAPESHIFTERS
Loneliness	TOMCRAFT
Lonely	AKON
Lonely This Christmas	MUD
Long Haired Lover From Liverpool	LITTLE JIMMY OSMOND
Long Live Love	SANDIE SHAW
Look Right Through	STORM QUEEN
Lose Yourself	EMINEM
Louder	DJ FRESH FT SIAN EVANS
Love Can Build A Bridge	CHER, CHRISSIE HYNDE, NENEH CHERRY WITH ERIC CLAPTON
Love Don't Cost A Thing	JENNIFER LOPEZ
Love Grows Where My Rosemary Goes	EDISON LIGHTHOUSE
Love Is All Around	WET WET WET
Love Me Again	JOHN NEWMAN
Love Me For A Reason	OSMONDS
Love Me Like You Do	ELLIE GOULDING
Love Won't Wait	GARY BARLOW
Love You More	JLS
Love Yourself	JUSTIN BIEBER
Lovers On The Sun	DAVID GUETTA FT SAM MARTIN
Lovesick Blues	FRANK IFIELD
Lucille	KENNY ROGERS
Lyla	OASIS
Mad World	MICHAEL ANDREWS FEAT. GARY JULES
Make It Easy On Yourself	WALKER BROTHERS
Make Luv	ROOM 5 FEAT. OLIVER CHEATHAM
Make Me Smile	STEVE HARLEY & COCKNEY REBEL
Making Your Mind Up	BUCKS FIZZ
Mama	SPICE GIRLS
Mama Do	PIXIE LOTT
Mama Weer All Crazee Now	SLADE
Mambo No 5	BOB THE BUILDER
Mambo No 5	LOU BEGA
Mamma Mia	ABBA
Mandy	WESTLIFE
Maneater	NELLY FURTADO
Maria	BLONDIE
Marie's The Name His Latest Flame	ELVIS PRESLEY
Marvin Gaye	CHARLIE PUTH FT MEGHAN TRAINOR
Mary's Boy Child - Oh My Lord	BONEY M
Massachusetts	BEE GEES
Matchstalk Men And Matchstalk Cats And Dogs	BRIAN & MICHAEL
Me And My Broken Heart	RIXTON
Meet Me Halfway	BLACK EYED PEAS
Men In Black	WILL SMITH
Mercy	DUFFY
Merry Christmas Everyone	SHAKIN' STEVENS
Merry Xmas Everybody	SLADE
Message In A Bottle	POLICE
Metal Guru	T REX
Mi Chico Latino	GERI HALLIWELL
Michael	HIGHWAYMEN
Michelle	OVERLANDERS
Mighty Quinn	MANFRED MANN
Millennium	ROBBIE WILLIAMS
Millennium Prayer	CLIFF RICHARD
Mirrors	JUSTIN TIMBERLAKE
Mississippi	PUSSYCAT
Mistletoe And Wine	CLIFF RICHARD
Mmmbop	HANSON
Money On My Mind	SAM SMITH
Mony Mony	TOMMY JAMES & THE SHONDELLS
Moon River	DANNY WILLIAMS
More Than A Woman	AALIYAH
Mouldy Old Dough	LIEUTENANT PIGEON
Move Closer	PHYLLIS NELSON
Mr Blobby	MR BLOBBY
Mr Tambourine Man	BYRDS
Mr Vain	CULTURE BEAT
Ms Grace	TYMES
Mull Of Kintyre	WINGS
Music	MADONNA
My Camera Never Lies	BUCKS FIZZ
My Ding-a-ling	CHUCK BERRY
My Heart Will Go On	CELINE DION
My Life Would Suck Without You	KELLY CLARKSON
My Love	ROUTE 94 FT JESS GLYNNE
My Love	WESTLIFE
My Old Man's A Dustman	LONNIE DONEGAN
My Place	NELLY
My Sweet Lord	GEORGE HARRISON
Mysterious Girl	PETER ANDRE FEAT. BUBBLER RANX
Nasty Girl	NOTORIOUS BIG FEAT. DIDDY, NELLY, JAGGED EDGE & AVERY STORM
Need U 100 Percent	DUKE DUMONT FT AME
Needles And Pins	SEARCHERS
Never Be The Same Again	MELANIE C & LISA 'LEFT EYE' LOPES
Never Ever	ALL SAINTS
Never Forget	TAKE THAT
Never Gonna Give You Up	RICK ASTLEY
Never Gonna Leave Your Side	DANIEL BEDINGFIELD
Never Had A Dream Come True	S CLUB 7
Never Leave You	TINCHY STRYDER FEAT. AMELLE BERRABAH
Night Fever	BEE GEES
No Charge	J.J. BARRIE
No Limit	2 UNLIMITED
No Matter What	BOYZONE
No Regrets	DAPPY
No Tomorrow	ORSON
Nobody To Love	SIGMA
Not Letting Go	TINIE TEMPAH FT JESS GLYNNE
Nothin' On You	BOB FT BRUNO MARS
Nothing Compares 2 U	SINEAD O'CONNOR
Nothing's Gonna Change My Love For You	GLENN MEDEIROS
Nothing's Gonna Stop Us Now	STARSHIP
Now You're Gone	BASSHUNTER FT DJ MENTAL THEO'S BAZZHEADZ
Number 1	TINCHY STRYDER FEAT. N-DUBZ
Nut Rocker	B.BUMBLE & THE STINGERS
Ob-la-di Ob-la-da	MARMALADE
Obviously	McFLY
Oh Boy	MUD
Oh Carolina	SHAGGY
Oh Julie	SHAKIN' STEVENS
Oh Pretty Woman	ROY ORBISON
Omg	USHER FT WILL I AM
On The Floor	JENNIFER LOPEZ FT PITBULL
On The Rebound	FLOYD CRAMER
Once	DIANA VICKERS
One Dance	DRAKE FT WIZKID & KYLA
One Day At A Time	LENA MARTELL
One Day In Your Life	MICHAEL JACKSON
One Moment In Time	WHITNEY HOUSTON
One Night	ELVIS PRESLEY
One Way Or Another	ONE DIRECTION
Only Girl	RIHANNA
Only The Lonely	ROY ORBISON
Only You	FLYING PICKETS
Ooh Aah Just A Little Bit	GINA G
Oops I Did It Again	BRITNEY SPEARS
Oopsy Daisy	CHIPMUNK
Orinoco Flow	ENYA
Out Of Time	CHRIS FARLOWE
Over And Over	NELLY FEAT. TIM MCGRAW
Paint It, Black	ROLLING STONES
Papa Don't Preach	MADONNA
Paperback Writer	BEATLES
Paradise	COLDPLAY
Part Of Me	KATY PERRY
Party Rock Anthem	LMFAO
Pass Out	TINIE TEMPAH
Pass The Dutchie	MUSICAL YOUTH
Patience	TAKE THAT
Payphone	MAROON 5 FT WIZ KHALIFA
Perfect	FAIRGROUND ATTRACTION
Perfect Day	VARIOUS ARTISTS
Perfect Moment	MARTINE MCCUTCHEON
Pillowtalk	ZAYN
Pipes Of Peace	PAUL MCCARTNEY
Please Don't Go	KWS
Please Don't Let Me Go	OLLY MURS
Please Don't Tease	CLIFF RICHARD & THE SHADOWS
Poetry In Motion	JOHNNY TILLOTSON
Poker Face	LADY GAGA
Poor Me	ADAM FAITH
Praise You	FATBOY SLIM
Pray	TAKE THAT
Prayer In C	LILLY WOOD & ROBIN SCHULZ
Precious	JAM
Pretty Flamingo	MANFRED MANN
Pretty Fly For A White Guy	OFFSPRING
Price Tag	JESSIE J FT BOB
Prince Charming	ADAM & THE ANTS
Problem	ARIANA GRANDE FT IGGY AZALEA
Professional Widow	TORI AMOS
Promise This	CHERYL COLE
Promises	NERO
Pump Up The Volume	M|A|R|R|S
Puppet On A String	SANDIE SHAW
Puppy Love	DONNY OSMOND
Pure And Simple	HEAR'SAY
Pure Shores	ALL SAINTS
Push The Button	SUGABABES
Put Your Hands Up For Detroit	FEDDE LE GRANDE
Queen Of My Heart	WESTLIFE
R I P	RITA ORA FT TINIE TEMPAH
Radio	ROBBIE WILLIAMS
Rat Trap	BOOMTOWN RATS
Rather Be	CLEAN BANDIT FT JESS GLYNNE
Reach For The Stars	SHIRLEY BASSEY
Reach Out I'll Be There	FOUR TOPS
Read All About It	PROFESSOR GREEN FT EMELI SANDE
Ready Or Not	FUGEES
Real To Me	BRIAN McFADDEN
Reason To Believe	ROD STEWART
Red Red Wine	UB 40
Reet Petite	JACKIE WILSON
Relax	FRANKIE GOES TO HOLLYWOOD
Release Me	ENGELBERT HUMPERDINCK
Relight My Fire	TAKE THAT FEATURING LULU
Replay	IYAZ
Respectable	MEL & KIM
Return Of The Mack	MARK MORRISON
Return To Sender	ELVIS PRESLEY WITH THE JORDANAIRES
Rhythm Is A Dancer	SNAP
Ride On Time	BLACK BOX
Right Round	FLO RIDA
Ring My Bell	ANITA WARD
Rise	GABRIELLE
Rivers Of Babylon	BONEY M
Roar	KATY PERRY
Rock A Hula Baby	ELVIS PRESLEY
Rock Dj	ROBBIE WILLIAMS
Rock Me Amadeus	FALCO
Rock Your Baby	GEORGE MCCRAE
Rockabye	CLEAN BANDIT 
Rollercoaster	B*WITCHED
Rollin'	LIMP BIZKIT
Round Round	SUGABABES
Royals	LORDE
Rubber Bullets	10 C.C.
Ruby	KAISER CHIEFS
Rude	MAGIC
Run	LEONA LEWIS
Run This Town	JAY-Z FEAT. RIHANNA & KANYE WEST
Runaway	DEL SHANNON
Running Bear	JOHNNY PRESTON
Sacrifice	ELTON JOHN
Sad Sweet Dreamer	SWEET SENSATION
Sadeness Part 1	ENIGMA
Sailing	ROD STEWART
Sailor	PETULA CLARK
Same Old Brand New You	A1
San Francisco	SCOTT MCKENZIE
Saturday Night	WHIGFIELD
Save Your Kisses For Me	BROTHERHOOD OF MAN
Save Your Love	RENEE & RENATO
Saving All My Love For You	WHITNEY HOUSTON
Saviour's Day	CLIFF RICHARD
Say You Won't Let Go	JAMES ARTHUR
Say You'll Be There	SPICE GIRLS
School's Out	ALICE COOPER
Scream & Shout	WILL I AM FT BRITNEY SPEARS
Sealed With A Kiss	JASON DONOVAN
Seasons In The Sun	TERRY JACKS
Seasons In The Sun	WESTLIFE
See My Baby Jive	WIZZARD
See You Again	WIZ KHALIFA FT CHARLIE PUTH
Setting Sun	CHEMICAL BROTHERS
Seven Tears	GOOMBAY DANCE BAND
Sex On Fire	KINGS OF LEON
Sexy Chick	DAVID GUETTA FEAT. AKON
Sexyback	JUSTIN TIMBERLAKE
Shaddap You Face	JOE DOLCE MUSIC THEATRE
Shakin' All Over	JOHNNY KIDD & THE PIRATES
Shape Of You	ED SHEERAN
She	CHARLES AZNAVOUR
She Looks So Perfect	5 SECONDS OF SUMMER
She Loves You	BEATLES
She Makes Me Wanna	JLS FT DEV
She's Not You	ELVIS PRESLEY
She's The One	ROBBIE WILLIAMS
Shine	TAKE THAT
Should I Stay Or Should I Go	CLASH
Shout	SHOUT FT DIZZEE & JAMES CORDEN
Shout Out To My Ex	LITTLE MIX
Show Me Heaven	MARIA MCKEE
Show You The Way To Go	JACKSONS
Sign Of The Times	HARRY STYLES
Silence Is Golden	TREMELOES
Silver Lady	DAVID SOUL
Sing	ED SHEERAN
Sing	GARY BARLOW/ COMMONWEALTH BAND
Singin' In The Rain	MINT ROYALE
Skweeze Me Pleeze Me	SLADE
Skyscraper	SAM BAILEY
Sleeping Satellite	TASMIN ARCHER
Slow	KYLIE MINOGUE
Smack That	AKON FEAT. EMINEM
Smile	LILY ALLEN
So Sick	NE-YO
So What	PINK
So You Win Again	HOT CHOCOLATE
Some Might Say	OASIS
Somebody Help Me	SPENCER DAVIS GROUP
Somebody That I Used To Know	GOTYE FT KIMBRA
Someone Like You	ADELE
Somethin' Stupid	NANCY SINATRA & FRANK SINATRA
Somethin' Stupid	ROBBIE WILLIAMS & NICOLE KIDMAN
Something About The Way You Look Tonight	ELTON JOHN
Something I Need	BEN HAENOW
Something In The Air	THUNDERCLAP NEWMAN
Somethings Gotten Hold Of My Heart	MARC ALMOND FEATURING SPECIAL GUEST STAR GENE PITNEY
Sometimes You Can't Make It On Your Own	U2
Somewhere Only We Know	LILY ALLEN
Son Of My Father	CHICORY TIP
Sorry	JUSTIN BIEBER
Sorry	MADONNA
Sorry Seems To Be The Hardest Word	BLUE FEAT.ELTON JOHN
Sound Of The Underground	GIRLS ALOUD
Space Oddity	DAVID BOWIE
Spaceman	BABYLON ZOO
Spectrum	FLORENCE & THE MACHINE
Spice Up Your Life	SPICE GIRLS
Spinning Around	KYLIE MINOGUE
Spirit In The Sky	DOCTOR & THE MEDICS
Spirit In The Sky	GARETH GATES FEAT. THE KUMARS
Spirit In The Sky	NORMAN GREENBAUM
Stan	EMINEM
Stand And Deliver	ADAM & THE ANTS
Stand By Me	BEN E. KING
Stand By Your Man	TAMMY WYNETTE
Star Girl	McFLY
Star Trekkin'	THE FIRM
Starry Eyed	MICHAEL HOLLIDAY WITH THE MICHAEL SAMMES SINGERS
Start	JAM
Start Without You	ALEXANDRA BURKE FT LAZA MORGAN
Stay	SHAKESPEAR'S SISTER
Stay Another Day	EAST 17
Stay Awake	EXAMPLE
Stay With Me	SAM SMITH
Stickwitu	PUSSYCAT DOLLS
Stitches	SHAWN MENDES
Stomp	STEPS
Stop Living The Lie	DAVID SNEDDON
Strangers In The Night	FRANK SINATRA
Stronger	KANYE WEST
Sugar Baby Love	RUBETTES
Sugar Sugar	ARCHIES
Suicide Is Painless	MASH
Summer	CALVIN HARRIS
Summer Holiday	CLIFF RICHARD & THE SHADOWS
Summer Nights	JOHN TRAVOLTA & OLIVIA NEWTON-JOHN
Sunday Girl	BLONDIE
Sunny Afternoon	KINKS
Super Trouper	ABBA
Sure	TAKE THAT
Surrender	ELVIS PRESLEY WITH THE JORDANAIRES
Survivor	DESTINY'S CHILD
Swagger Jagger	CHER LLOYD
Swear It Again	WESTLIFE
Sweet Like Chocolate	SHANKS & BIGFOOT
Sweet Nothing	CALVIN HARRIS
Sweets For My Sweet	SEARCHERS
Swing The Mood	JIVE BUNNY & THE MASTERMIXERS
Symphony	CLEAN BANDIT FT ZARA LARSSON
Tainted Love	SOFT CELL
Take A Bow	RIHANNA
Take A Chance On Me	ABBA
Take Me Back 'ome	SLADE
Take Me To The Clouds Above	LMC V U2
Take My Breath Away	BERLIN
Take On Me	A1
Talk Dirty	JASON DERULO FT 2 CHAINZ
Tears	KEN DODD
Tears Of A Clown	SMOKEY ROBINSON & THE MIRACLES
Tears On My Pillow	JOHNNY NASH
Tears On My Pillow	KYLIE MINOGUE
Telegram Sam	T REX
Telephone	LADY GAGA & BEYONCE
Teletubbies Say Eh-oh!	TELETUBBIES
Tell Laura I Love Her	RICKY VALANCE
Telstar	TORNADOS
Temptation	EVERLY BROTHERS
That's My Goal	SHAYNE WARD
That's Not My Name	TING TINGS
That's What I Like	JIVE BUNNY & THE MASTERMIXERS
The Ballad Of Bonnie And Clyde	GEORGIE FAME
The Ballad Of John And Yoko	BEATLES
The Carnival Is Over	SEEKERS
The Chicken Song	SPITTING IMAGE
The Climb	JOE McELDERRY
The Club Is Alive	JLS
The Drugs Don't Work	VERVE
The Edge Of Heaven	WHAM!
The Fear	LILY ALLEN
The Final Countdown	EUROPE
The First Time	ROBIN BECK
The Fly	U2
The Good The Bad And The Ugly	HUGO MONTENEGRO & HIS ORCHESTRA & CHORUS
The Hindu Times	OASIS
The House Of The Rising Sun	ANIMALS
The Importance Of Being Idle	OASIS
The Joker	STEVE MILLER BAND
The Ketchup Song	LAS KETCHUP
The Lady In Red	CHRIS DE BURGH
The Land Of Make Believe	BUCKS FIZZ
The Last Time	ROLLING STONES
The Last Waltz	ENGELBERT HUMPERDINCK
The Lazy Song	BRUNO MARS
The Legend Of Xanadu	DAVE DEE, DOZY, BEAKY, MICK & TICH
The Lion Sleeps Tonight	TIGHT FIT
The Long And Winding Road	WILL YOUNG & GARETH GATES
The Man	ALOE BLACC
The Masses Against The Classes	MANIC STREET PREACHERS
The Minute You're Gone	CLIFF RICHARD
The Model	KRAFTWERK
The Monster	EMINEM FT RIHANNA
The Most Beautiful Girl In The World	PRINCE
The Name Of The Game	ABBA
The Next Time	CLIFF RICHARD & THE SHADOWS
The Official Bbc Children In Need Medley	PETER KAY'S ANIMATED ALL STAR
The One And Only	CHESNEY HAWKES
The Only Way Is Up	YAZZ & THE PLASTIC POPULATION
The Power	SNAP
The Power Of Love	FRANKIE GOES TO HOLLYWOOD
The Power Of Love	GABRIELLE APLIN
The Power Of Love	JENNIFER RUSH
The Promise	GIRLS ALOUD
The Real Slim Shady	EMINEM
The Real Thing	TONY DI BART
The Reflex	DURAN DURAN
The Rose	WESTLIFE
The Roussos Phenomenon Ep	DEMIS ROUSSOS
The Shoop Shoop Song	CHER
The Stonk	HALE & PACE & THE STONKERS
The Streak	RAY STEVENS
The Sun Ain't Gonna Shine Anymore	WALKER BROTHERS
The Sun Always Shines On Tv	A-HA
The Tide Is High	ATOMIC KITTEN
The Tide Is High	BLONDIE
The Time	BLACK EYED PEAS
The Twelfth Of Never	DONNY OSMOND
The Way I Are	TIMBALAND FEAT. DOE & KERI HILSON
The Way To Your Love	HEAR'SAY
The Wayward Wind	FRANK IFIELD
The Winner Takes It All	ABBA
The Wonder Of You	ELVIS PRESLEY
The Young Ones	CLIFF RICHARD & THE SHADOWS
Theme From S-express	S-EXPRESS
There Must Be An Angel	EURYTHMICS
There's Always Something There To Remind Me	SANDIE SHAW
There's No One Quite Like Grandma	ST WINIFRED'S SCHOOL CHOIR
These Boots Are Made For Walkin'	NANCY SINATRA
These Days	TAKE THAT
These Words	NATASHA BEDINGFIELD
Things Can Only Get Better	D:REAM
Think Twice	CELINE DION
Thinking Out Loud	ED SHEERAN
This Ain't A Love Song	SCOUTING FOR GIRLS
This Is Love	WILL I AM FT EVA SIMONS
This Is My Song	PETULA CLARK
This Ole House	SHAKIN' STEVENS
Those Were The Days	MARY HOPKIN
Three Lions	BADDIEL & SKINNER & LIGHTNING SEEDS
Three Lions '98	BADDIEL & SKINNER & LIGHTNING SEEDS
Three Steps To Heaven	EDDIE COCHRAN
Three Times A Lady	COMMODORES
Thrift Shop	MACKLEMORE
Thunder In My Heart Again	MECK FEAT. LEO SAYER
Thunderbirds/3am	BUSTED
Ticket To Ride	BEATLES
Tie A Yellow Ribbon Round The Old Oak Tree	DAWN FEATURING TONY ORLANDO
Tiger Feet	MUD
Timber	PITBULL FT KESHA
Tired Of Waiting For You	KINKS
Titanium	DAVID GUETTA FT SIA
To You I Belong	B*WITCHED
Toca's Miracle	FRAGMA
Together We Are Beautiful	FERN KINNEY
Too Close	BLUE
Too Many Broken Hearts	JASON DONOVAN
Too Much	SPICE GIRLS
Too Shy	KAJAGOOGOO
Total Eclipse Of The Heart	BONNIE TYLER
Touch Me	RUI DA SILVA FEATURING CASSANDRA
Tower Of Strength	FRANKIE VAUGHAN
Toxic	BRITNEY SPEARS
Tragedy	BEE GEES
Tragedy	STEPS
Troublemaker	OLLY MURS FT FLO RIDA
True	SPANDAU BALLET
True Blue	MADONNA
Tsunami	DVBBS & BORGEOUS
Turn Back Time	AQUA
Turn The Music Louder	KDA FT TINIE TEMPAH & KATY B
Turn Up The Music	CHRIS BROWN
Turtle Power	PARTNERS IN KRYME
Twilight	COVER DRIVE
Twist & Shout	CHAKA DEMUS & PLIERS FEATURING JACK RADICS & TAXI GANG
Two Little Boys	ROLF HARRIS
Two Tribes	FRANKIE GOES TO HOLLYWOOD
Umbrella	RIHANNA FEAT. JAY-Z
Unbreakable	WESTLIFE
Unchained Melody	GARETH GATES
Unchained Melody	RIGHTEOUS BROTHERS
Unchained Melody	ROBSON GREEN & JEROME FLYNN
Under Control	CALVIN HARRIS
Under Pressure	QUEEN & DAVID BOWIE
Under The Bridge	ALL SAINTS
Under The Moon Of Love	SHOWADDYWADDY
Up On The Roof	ROBSON GREEN & JEROME FLYNN
Up Town Top Ranking	ALTHIA & DONNA
Uptown Funk	MARK RONSON FT BRUNO MARS
Uptown Girl	BILLY JOEL
Uptown Girl	WESTLIFE
Use It Up And Wear It Out	ODYSSEY
Vertigo	U2
Video Killed The Radio Star	BUGGLES
Vincent	DON MCLEAN
Viva Forever	SPICE GIRLS
Viva La Vida	COLDPLAY
Vogue	MADONNA
Voodoo Chile	JIMI HENDRIX EXPERIENCE
Waiting All Night	RUDIMENTAL FT ELLA EYRE
Wake Me Up	AVICII
Wake Me Up	GARETH MALONE'S ALL STAR CHOIR
Wake Me Up Before You Go-go	WHAM!
Walk Right Back	EVERLY BROTHERS
Walk This Way	SUGABABES VS GIRLS ALOUD
Walkin' Back To Happiness	HELEN SHAPIRO
Walking On The Moon	POLICE
Wandrin' Star	LEE MARVIN
Wannabe	SPICE GIRLS
Want To Want Me	JASON DERULO
Waterloo	ABBA
Waves	MR PROBZ
Way Down	ELVIS PRESLEY
We Are The World	USA FOR AFRICA
We Are Young	FUN FT JANELLE MONAE
We Can't Stop	MILEY CYRUS
We Don't Talk Anymore	CLIFF RICHARD
We Found Love	RIHANNA FT CALVIN HARRIS
We No Speak Americano	YOLANDA BE COOL VS D CUP
We R Who We R	KESHA
We Will Rock You	FIVE & QUEEN
We're Going To Ibiza!	VENGABOYS
Welcome Home	PETERS & LEE
Welcome To The Black Parade	MY CHEMICAL ROMANCE
Well I Ask You	EDEN KANE
West End Girls	PET SHOP BOYS
What A Wonderful World	EVA CASSIDY & KATIE MELUA
What A Wonderful World	LOUIS ARMSTRONG
What About Us	SATURDAYS FT SEAN PAUL
What Becomes Of The Brokenhearted	ROBSON GREEN & JEROME FLYNN
What Do You Mean	JUSTIN BIEBER
What Do You Mean?	JUSTIN BIEBER
What Makes You Beautiful	ONE DIRECTION
What Took You So Long	EMMA BUNTON
What's Another Year	JOHNNY LOGAN
What's My Name	RIHANNA FT DRAKE
When A Child Is Born	JOHNNY MATHIS
When I Need You	LEO SAYER
When Love Takes Over	DAVID GUETTA FEAT. KELLY ROWLAND
When The Going Gets Tough	BOYZONE
When The Going Gets Tough, The Tough Get Going	BILLY OCEAN
When The Sun Goes Down	ARCTIC MONKEYS
When We Collide	MATT CARDLE
When Will I See You Again	THREE DEGREES
When You Believe	LEON JACKSON
When You Say Nothing At All	RONAN KEATING
When You're In Love With A Beautiful Woman	DR HOOK
Where Are You Now	JACKIE TRENT
Where Do You Go To My Lovely	PETER SARSTEDT
Where Is The Love	BLACK EYED PEAS
Wherever I Lay My Hat	PAUL YOUNG
Wherever You Are	MILITARY WIVES
Whispering Grass	WINDSOR DAVIES & DON ESTELLE
Who's David	BUSTED
Who's That Girl	MADONNA
Whole Again	ATOMIC KITTEN
Why	ANTHONY NEWLEY
Wild Thoughts	DJ KHALED FT RIHANNA & BRYSON TILLER
Wings	LITTLE MIX
Wishing On A Star	X FACTOR FINALISTS 2011
With A Girl Like You	TROGGS
With A Little Help From My Friends	JOE COCKER
With A Little Help From My Friends	SAM & MARK
With A Little Help From My Friends	WET WET WET
With Every Heartbeat	ROBYN WITH KLEERUP
Without Me	EMINEM
Without You	MARIAH CAREY
Without You	NILSSON
Woman	JOHN LENNON
Woman In Love	BARBRA STREISAND
Wonderful	JA RULE FEAT. R.KELLY & ASHANTI
Wonderful Land	SHADOWS
Wooden Heart	ELVIS PRESLEY
Woodstock	MATTHEW'S SOUTHERN COMFORT
Words	BOYZONE
Working My Way Back To You - Forgive Me Girl	DETROIT SPINNERS
World In Motion	ENGLANDNEWORDER
World Of Our Own	WESTLIFE
Would I Lie To You	CHARLES & EDDIE
Wrecking Ball	MILEY CYRUS
Writing's On The Wall	SAM SMITH
Written In The Stars	TINIE TEMPAH
Wuthering Heights	KATE BUSH
Xanadu	OLIVIA NEWTON-JOHN & ELECTRIC LIGHT ORCHESTRA
Y M C A	VILLAGE PEOPLE
Yeah	USHER FEAT. LIL' JON & LUDACRIS
Yeh Yeh	GEORGIE FAME & THE BLUE FLAMES
Yellow River	CHRISTIE
Yellow Submarine	BEATLES
Yes Sir I Can Boogie	BACCARA
You Are Not Alone	MICHAEL JACKSON
You Are Not Alone	X FACTOR FINALISTS 2009
You Can't Hurry Love	PHIL COLLINS
You Don't Have To Say You Love Me	DUSTY SPRINGFIELD
You Don't Know	HELEN SHAPIRO
You Don't Know Me	ARMAND VAN HELDEN FEATURING DUANE HAEDEN
You Got It	NEW KIDS ON THE BLOCK
You Make Me Wanna	USHER
You Needed Me	BOYZONE
You Raise Me Up	WESTLIFE
You Really Got Me	KINKS
You Said No	BUSTED
You See The Trouble With Me	BLACK LEGEND
You Spin Me Round	DEAD OR ALIVE
You To Me Are Everything	REAL THING
You Wear It Well	ROD STEWART
You Win Again	BEE GEES
You Won't Find Another Fool Like Me	NEW SEEKERS
You'll Never Stop Me Loving You	SONIA
You'll Never Walk Alone	CROWD
You'll Never Walk Alone	GERRY & THE PACEMAKERS
You're Beautiful	JAMES BLUNT
You're Driving Me Crazy	TEMPERANCE SEVEN
You're My World	CILLA BLACK
You're Not Alone	OLIVE
You're The Devil In Disguise	ELVIS PRESLEY WITH THE JORDANAIRES
You're The First The Last My Everything	BARRY WHITE
You're The One That I Want	JOHN TRAVOLTA & OLIVIA NEWTON-JOHN
You've Lost That Loving Feelin'	RIGHTEOUS BROTHERS
Young	TULISA
Young At Heart	BLUEBELLS
Young Girl	UNION GAP FEATURING GARY PUCKETT
Young Love	DONNY OSMOND
Your Woman	WHITE TOWN

